Getting Lists...
52°North Initiative for Geospatial Open Source Software GmbH ---> ['javascript', 'java', 'ogc standards', 'web services']
aimacode ---> ['python', 'java', 'javascript']
AOSSIE - The Australian National University's Open-Source Software Innovation and Education ---> ['scala', 'lisp', 'llvm', 'python', 'postgresql']
Apache Software Foundation ---> ['java', 'ruby', 'python', 'javascript', 'couchdb']
ArchC ---> ['c++', 'python', 'archc']
ASCEND ---> ['python', 'c', 'c/c++']
BeagleBoard.org ---> ['beaglebone', 'javascript', 'python', 'linux', 'c']
Beam Community ---> ['erlang', 'elixir', 'xmpp', 'beam', 'mqtt']
Berkman Center for Internet and Society ---> ['ruby on rails', 'javascript', 'sql/nosql', 'meteor.js', 'go']
BioJS ---> ['javascript', 'python']
Biomedical Informatics, Emory University ---> ['java', 'medical imaging', 'deep learning', 'hadoop', 'python']
Blender Foundation ---> ['c', 'c++', 'python', 'opengl']
Boston University / XIA ---> ['xia', 'c', 'linux kernel', 'advanced data structures']
BRL-CAD ---> ['opencl', 'opengl', 'c/c++', 'python', 'tcl']
BuildmLearn ---> ['python', 'django', 'bootstrap', 'android']
Canadian Centre for Computational Genomics (C3G) - Montreal node ---> ['python', 'r-project', 'javascript', 'sql', 'git']
Catrobat ---> ['android', 'java', 'html5', 'web', 'javascript']
cBioPortal for Cancer Genomics ---> ['java', 'javascript', 'web', 'html', 'big data']
CCExtractor Development ---> ['c', 'video', 'ffmpeg', 'subtitles', 'linux']
Celluloid ---> ['ruby', 'multi-threading', 'multi-core', 'zeromq', 'high-resolution timers']
Ceph ---> ['c/c++', 'python', 'object-storage']
CERN SFT ---> ['c++', 'python', 'javascript', 'clang']
Chapel ---> ['python', 'chapel', 'c', 'c++', 'high performance computing']
CiviCRM ---> ['php', 'javascript', 'mysql', 'angularjs', 'd3js']
Classical Language Toolkit ---> ['python', 'javascript', 'java']
CloudCV ---> ['python', 'javascript', 'lua', 'caffe', 'torch']
Computational Biology @ University of Nebraska-Lincoln ---> ['webgl', 'javascript', 'mysql', 'react']
Computational Science and Engineering at TU Wien ---> ['javascript', 'html', 'css', 'java', 'c++']
Copyleft Games ---> ['python', 'opengl', 'c']
coreboot ---> ['c', 'assembly', 'open hardware']
CVXPY ---> ['python']
D Foundation ---> ['dlang', 'c++']
dbpediaspotlight ---> ['java', 'scala', 'rdf', 'python', 'nosql']
Debian Project ---> ['python', 'c', 'c++', 'ruby', 'django']
Discourse ---> ['ruby', 'ruby on rails', 'javascript', 'ember', 'docker']
Distributed and Unified Numerics Environment (DUNE) ---> ['c++', 'python', 'cmake']
Django Software Foundation ---> ['python', 'django']
Drupal ---> ['php', 'symfony', 'sql', 'javascript', 'html5']
Eclipse Foundation ---> ['java', 'geospatial', 'c/c++']
Fedora Project ---> ['python', 'flask', 'postgresql', 'html5', 'javascript']
FFmpeg ---> ['c', 'asm', 'git']
FOSDEM VZW ---> ['ruby on rails', 'postgresql', 'git']
FOSSASIA ---> ['javascript', 'android', 'python', 'java', 'json api']
Free and Open Source Silicon Foundation ---> ['open hardware', 'fpga', 'compiler', 'python', 'javascript']
FreeBSD ---> ['c/c++', 'clang', 'llvm', 'shell script', 'make']
Freifunk ---> ['openwrt', 'olsr', 'batman', 'c', 'lua']
Gambit - Software Tools for Game Theory ---> ['javascript']
Ganeti ---> ['python', 'haskell', 'kvm', 'xen', 'virtualization']
Genes, Genomes and Variation ---> ['mysql', 'javascript', 'perl']
Gentoo Foundation ---> ['shell script', 'c/c++', 'python', 'perl', 'sql']
Git ---> ['c', 'shell script', 'git']
GitHub ---> ['git', 'atom', 'node.js', 'ruby', 'c#']
Global Alliance for Genomics & Health ---> ['python', 'java', 'protobuf', 'sql']
GNOME ---> ['c', 'python', 'javascript', 'gtk+']
gnss-sdr ---> ['c/c++', 'c++11', 'c++14', 'gnss']
GNU Mailman ---> ['python', 'email', 'django']
GNU Octave ---> ['hg', 'c++']
GNU Project ---> ['posix', 'c', 'lisp', 'python', 'eiffel']
GNU Radio ---> ['c++', 'python', 'software radio', 'dsp', 'rf']
GPAC ---> ['mp4', 'dash', 'mp4box', 'javascript', 'c++']
Green Navigation ---> ['javascript', 'postgresql', 'polymer', 'go', 'electromobility']
gRPC ---> ['distributed systems', 'networking', 'micro-services', 'scalability', 'http/2']
Health Information Systems Programme ---> ['java', 'android', 'javascript', 'reactjs', 'gradle']
Homebrew ---> ['ruby', 'git', 'osx']
Inclusive Design Institute ---> ['javascript', 'jquery', 'html5', 'css', 'node.js']
Indic Project ---> ['android', 'python', 'javascript', 'ruby on rails', 'c++']
Inkscape ---> ['c++', 'python', 'svg', 'css', 'gtk+']
International Neuroinformatics Coordinating Facility ---> ['c++', 'python', 'gpu', 'javascript', 'java']
Java Pathfinder Team ---> ['java', 'jvm', 'android', 'distributed systems']
JBoss Community ---> ['java', 'android', 'ide', 'aerogear', 'asciidoctor']
Jenkins Project ---> ['java', 'groovy', 'jenkins', 'css', 'html']
Joomla! ---> ['php', 'css', 'html', 'javascript', 'jquery']
jQuery Foundation ---> ['javascript', 'html5', 'css', 'jquery']
JSK Robotics Laboratory ---> ['euslisp', 'openhrp', 'openrtm', 'ros']
KDE ---> ['qt', 'cmake', 'c++', 'php']
KolibriOS ---> ['fasm', 'flat assembler', 'x86 assembly', 'i386', 'i586']
LabLua ---> ['lua', 'luarocks', 'elasticsearch', 'netbsd', 'céu']
LibreOffice ---> ['c++', 'python', 'java', 'android', 'opengl']
Libvirt ---> ['c', 'qemu', 'xen', 'containers']
Liquid Galaxy Project ---> ['javascript', 'ros', 'gis', 'cesium']
lowRISC ---> ['verilog', 'fpga', 'chisel', 'c++', 'linux']
MariaDB ---> ['mysql', 'mariadb', 'c', 'perl']
Matrix.org ---> ['react', 'android', 'ios', 'golang', 'python']
MBDyn, Department of Aerospace Science and Technology at Politecnico di Milano ---> ['c++']
McGill Space Institute ---> ['python', 'sql', 'databases', 'big data']
MetaBrainz Foundation ---> ['python', 'perl', 'postgresql', 'javascript']
Mifos Initiative ---> ['java', 'javascript', 'angularjs', 'android', 'mysql']
MIT Media Lab ---> ['java', 'html/javascript', 'android']
Mixxx DJ Software ---> ['c++11', 'c++', 'qt', 'audio', 'opengl']
mlpack: a scalable C++ machine learning library ---> ['c++']
Mobile Robot Programming Toolkit (MRPT) ---> ['c++', 'ros', 'opencv', 'cmake', 'qt']
ModSecurity ---> ['waf', 'web application firewall']
Moodle ---> ['php', 'jquery', 'mysql', 'postgresql', 'javascript']
MovingBlocks ---> ['java', 'lwjgl', 'opengl', 'blender', 'gradle']
Mozilla ---> ['c++', 'python', 'javascript', 'html', 'rust']
MuseScore ---> ['qt', 'c/c++', 'qml']
National Resource for Network Biology (NRNB) ---> ['c++', 'java', 'javascript', 'php', 'python']
Netfilter project ---> ['firewall', 'linux kernel', 'networking']
Nmap Security Scanner ---> ['c/c++', 'lua', 'python', 'c', 'c++']
NumFOCUS ---> ['python', 'javascript', 'julia', 'r']
Open Bioinformatics Foundation ---> ['perl', 'python', 'ruby', 'java', 'haskell']
Open Chemistry ---> ['c++', 'opengl', 'python', 'javascript', 'webgl']
Open Detection ---> ['c/c++', 'cmake', 'opencv', 'pcl', 'caffe']
Open Ephys ---> ['c++', 'juce']
Open Genome Informatics ---> ['python', 'java', 'html/javascript', 'nodejs', 'gwt']
Open Source Robotics Foundation ---> ['ros', 'gazebo']
OpenAstronomy ---> ['python', 'julia', 'c', 'numpy']
OpenCV ---> ['c++', 'python', 'machine learning', 'computer vision']
OpenKeychain (OpenPGP for Android) ---> ['android', 'openpgp']
OpenMRS ---> ['java', 'groovy', 'html5', 'xml', 'hibernate']
OpenStreetMap ---> ['postgis', 'java', 'ruby', 'javascript', 'opengl']
openSUSE ---> ['ruby on rails', 'angularjs', 'docker', 'linux', 'ruby']
Oppia Foundation ---> ['javascript', 'app engine', 'python', 'css', 'angularjs']
Orange – Data Mining Fruitful & Fun ---> ['python', 'cython', 'qt', 'machine learning']
OSGeo - The Open Source Geospatial Foundation ---> ['python', 'sql', 'c', 'ogc standards', 'c++']
OSU Open Source Lab ---> ['python', 'rest', 'javascript', 'ruby']
OWASP Foundation ---> ['python', 'php', 'javascript', 'java', 'html']
ownCloud ---> ['javascript', 'php', 'css', 'html', 'sql']
P2PSP.org ---> ['python', 'c++', 'webrtc', 'android', 'ios']
Peragro ---> ['python', 'blender', 'javascript', 'celery', 'django']
Performance Co-Pilot ---> ['golang', 'ruby', 'java', 'linux kernel', 'javascript']
Physical Web Project ---> ['internet of things', 'beacons', 'python', 'arduino']
PLASMA-UMass ---> ['javascript', 'c/c++', 'scala', 'go']
Plone Foundation ---> ['python', 'zope', 'javascript', 'rest', 'nosql']
Portland State University ---> ['open hardware', 'language-agnostic']
PRISM Model Checker ---> ['java', 'c++']
Public Lab ---> ['javascript', 'ruby on rails', 'leaflet', 'webrtc']
Python Software Foundation ---> ['python', 'mercurial']
QEMU ---> ['c', 'assembly', 'kvm']
R project for statistical computing ---> ['r', 'c', 'c++', 'fortran']
radare ---> ['c', 'rust']
ReactOS ---> ['c/c++', 'c']
Red Hen Lab ---> ['high performance computing', 'machine learning', 'opencv', 'audio procesing', 'multimodal analysis']
Robocomp ---> ['c++', 'python', 'zeroc ice', 'cmake', 'gnu/linux']
RTEMS Project ---> ['c', 'python', 'waf', 'embedded systems']
Ruby ---> ['ruby']
Ruby Science Foundation ---> ['ruby', 'c programming', 'jruby', 'c/c++']
Sage Mathematical Software System ---> ['python', 'javascript', 'cython', 'c++']
Scala ---> ['scala', 'jvm']
Scilab Enterprises ---> ['scilab', 'c++', 'java', 'c', 'fortran']
ScummVM ---> ['c++', 'sdl', 'opengl', 'assembly']
Shogun Machine Learning Toolbox ---> ['c++', 'python', 'swig', 'cmake']
Sigmah ---> ['java', 'gwt']
Soletta Project ---> ['c', 'python', 'javascript', 'networking', 'machine learning']
Stony Brook University Biomedical Informatics ---> ['medical imaging', 'bioinformatics', 'hadoop', 'big data']
strace ---> ['linux', 'c', 'git', 'shell script', 'make']
Sugar Labs ---> ['python', 'javascript', 'gtk+']
Sustainable Computing Research Group ( SCoRe ) ---> ['java', 'android', 'hadoop', 'python', 'golang']
SymPy ---> ['python', 'c++']
Systers, an Anita Borg Institute Community ---> ['python', 'android', 'ios', 'mysql', 'ruby on rails']
TARDIS-SN ---> ['python', 'cython', 'c']
TEAMMATES @ National University of Singapore ---> ['java', 'app engine', 'javascript', 'css', 'html']
The Apertium Project ---> ['c++', 'python', 'perl', 'xml', 'finite-state technologies']
The Center for Connected Learning and Computer-Based Modeling ---> ['javascript', 'scala', 'java', 'html5', 'css']
The Honeynet Project ---> ['android', 'machine learning', 'honeypots', 'python', 'html/javascript']
The Julia Language ---> ['julia', 'atom', 'c++', 'javascript', 'c']
The Linux Foundation ---> ['c', 'c++', 'python', 'mysql', 'cups']
The LLVM Compiler Infrastructure ---> ['c', 'c++', 'llvm', 'clang']
The Monarch Initiative ---> ['semantic web', 'javascript', 'text mining', 'named entity recognition', 'ontologies']
The NetBSD Foundation ---> ['bsd', 'security', 'networking', 'c programming', 'kernel']
The STE||AR Group ---> ['parallel processing', 'high performance computing', 'c++', 'cuda', 'opencl']
The syslog-ng project ---> ['c', 'java', 'python', 'big data', 'rust']
The Tor Project ---> ['c', 'javascript', 'golang', 'python', 'browser extensions']
The Wine Project ---> ['c', 'opengl', 'directx', 'x11', 'win32']
Timelab Technologies Ltd. ---> ['python', 'javascript']
TimVideos.us ---> ['vhdl', 'verilog', 'fpga', 'python', 'c']
Unitex/GramLab ---> ['java', 'c++']
Urban Energy Systems Laboratory, Empa ---> ['python', 'milp', 'gis']
Vert.x ---> ['java', 'reactive', 'javascript', 'groovy', 'micro-services']
VideoLAN / VLMC Project ---> ['opengl', 'c++', 'c', 'assembly', 'qt']
vitrivr ---> ['java', 'web', 'computer vision', 'machine learning', 'databases']
Wayland ---> ['opengl', 'wayland', 'c', 'xml', 'kms']
Wikimedia Foundation ---> ['php', 'javascript', 'html', 'css', 'jquery']
WSO2 ---> ['middleware', 'java', 'soa', 'distributed computing', 'web services']
X.Org Foundation ---> ['c', 'c++', 'opengl', 'vulkan', 'opencl']
Xapian Search Engine Library ---> ['c++', 'unicode', 'swig', 'android', 'golang']
XWiki ---> ['java', 'javascript', 'html5', 'css3', 'velocity']
Zulip Open Source Project ---> ['python', 'javascript', 'django', 'android', 'ios']
